0,0,0,0,0,0,0,0,0,0,0,0,0,0,0,0,0,0,0
0,A,0,0,A,0,0,0,A,0,A,0,0,0,A,0,0,A,0,
0,A,0,0,A,0,0,0,A,0,A,0,0,0,A,0,0,A,0,
0,A,A,A,A,A,A,A,A,A,A,A,A,A,A,A,A,A,0,
0,A,0,0,A,0,A,0,0,0,0,0,A,0,A,0,0,A,0,
0,A,A,A,A,0,A,A,A,0,A,A,A,0,A,A,A,A,0,
0,0,0,0,A,0,0,0,Y,0,Y,0,0,0,A,0,0,0,0,
X,X,X,0,A,0,Y,Y,Y,Y,Y,Y,Y,0,A,0,X,X,X,
0,0,0,0,A,0,Y,0,0,U,0,0,Y,0,A,0,0,0,0,
Y,Y,Y,Y,A,Y,Y,0,¤,¤,¤,¤,0,Y,Y,A,Y,Y,Y,
F